{
  "id": "defend_25_turns_30",
  "name": "坚守25回合·30×30",
  "description": "Defend 模式：4 城堡，撑过 25 回合即胜",
  "biome": "grass",
  "size": 30,
  "win_condition": "defend",
  "defend_turns": 25,
  "chars": {
    "P": "plain",
    "F": "forest",
    "M": "mountain",
    "R": "river",
    "C": "castle",
    "v": "village",
    "b": "barracks",
    "r": "road",
    "g": "gate"
  },
  "layout": [
    "CCvCCCCCCCCCCCCCCCCCCvCCCCCPPP",
    "CCCCCCCCCCCCCCCCCCCCCCCCCCCPPP",
    "CCbCCCCCCCCCCCCCCCCCCCCCCCPPPP",
    "CCCCCCCCCCCCCCCCCCCCCCCCCCCPPP",
    "CCCCCCCCCCCCCCCCCCCCCCCCCCCPPP",
    "CCCPPPPPPPPPPPPPPCCCCCCCCCCPPP",
    "CCCPrrrrrrrrrrrPCCCCCCCCCCPPPP",
    "CCCPrCFFFFFFFFFFrPCCCCCCCCPPPP",
    "CCCPrCFFFFFFFFFFrPCCCCCCCCPPPP",
    "CCCPrCFFFFFFFFFFrPCCCCCCCCPPPP",
    "CCCPrCCCCCCCCCCCCrPCCCCCCCPPPP",
    "CCCPrCFFFFFFFFFFrPCCCCCCCCPPPP",
    "CCCPrCFFFFFFFFFFrPCCCCCCCCPPPP",
    "CCCPrCFFFFFFFFFFrPCCCCCCCCPPPP",
    "CCCPrCCCCCCMMMMCrPCCCCCCCCPPPP",
    "CCCPrCCCCCCMMMMCrPCCCCCCCCPPPP",
    "CCCPrCCCCCCMMMMCrPCCCCCCCCPPPP",
    "CCCPrCCCCCCMMMMCrPCCCCCCCCPPPP",
    "CCCPrCCCCCCCCCCCCrPCCCCCCCCPPP",
    "CCCPrrrrrrrrrrrrPCCCCCCCCCCPPP",
    "CCCPPPPPPPPPPPPPPCCCCCCCCCCPPP",
    "CCCCCCCCCCCCCCCCCCCCCCCCCCCPPP",
    "CCCCCCCCCCCCCCCCCCCCCCCCCCCPPP",
    "CCbCCCCCCCCCCCCCCCCCCCCCCCPPPP",
    "CCCCCCCCCCCCCCCCCCCCCCCCCCCPPP",
    "CCvCCCCCCCCCCCCCCCCCCvCCCCCPPP",
    "CCCCCCCCCCCCCCCCCCCCCCCCCCCPPP",
    "CCbCCCCCCCCCCCCCCCCCCCCCCCPPPP",
    "CCCCCCCCCCCCCCCCCCCCCCCCCCCPPP",
    "CCvCCCCCCCCCCCCCCCCCCvCCCCCPPP"
  ]
}