{
  "id": "reach_corner_40",
  "name": "抢角·40×40",
  "description": "Reach 模式：4 人抢 (0,0)，节奏快、有大量森林屏障",
  "biome": "grass",
  "size": 40,
  "win_condition": "reach",
  "reach_tile": {
    "x": 0,
    "y": 0
  },
  "chars": {
    "P": "plain",
    "F": "forest",
    "M": "mountain",
    "R": "river",
    "C": "castle",
    "v": "village",
    "b": "barracks",
    "r": "road",
    "g": "gate"
  },
  "layout": [
    "vCCCCCCCCCCCCCCCCCCCCCCCCCCCCCCCCCCCPPPP",
    "CCCCCCCCCCCCCCCCCCCCCCCCCCCCCCCCCCCCPPPP",
    "CCCCCCCCCCCCCCCCCCCCCCCCCCCCCCCCCCCCPPPP",
    "CCCCCCbCCCCCFFFFFFFFFFFFFFFFCCCCCCCCCPPP",
    "CCCCCCCCCCCFFFFFFFFFFFFFFFFCCCCCCCCCPPPP",
    "CCCCCCCCCCCFFFFFFFFFFFFFFFFCCCCCCCCCPPPP",
    "CCCCCCCCCCCFFFFFFFFFFFFFFFFCCCCCCCCCPPPP",
    "CCCCCCCCCCCCFFFFFFFFFFFFFFFFFFCCCCCCPPPP",
    "CCCCCCCCCCCCFFFFFFFFFFFFFFFFFFCCCCCCPPPP",
    "CCCCCCCCCCCCCRRRRRRRRRRRRRRRCCCCCCCCCPPP",
    "CCCCCCCCCCCCCRRRRRRRRRRRRRRCCCCCCCCCPPPP",
    "CCCCCCCCCCCCCCRRRRRRRRRRRRRCCCCCCCCCCPPP",
    "CCCCCCCCCCCCCCCCFFFFFFFFFFFFCCCCCCCCCPPP",
    "CCCCCCCCCCCCCCCCFFFFFFFFFFFFCCCCCCCCCPPP",
    "CCCCCCCCCCCCCCCCCCCCFFFFFFFFFFCCCCCCPPPP",
    "CCCCCCCCCCCCCCCCCCCCFFFFFFFFFFCCCCCCPPPP",
    "CCCCCCCCCCCCCCCCCCCCCCFFFFFFFFFCCCCCCPPP",
    "CCCCCCCCCCCCCCCCCCCCCCCFFFFFFFFCCCCCCPPP",
    "CCCCCCCCCCCCCCCCCCCCCCCCCFFFFFFFFCCCCPPP",
    "CCCCCCCCCCCCCCCCCCCCCCCCCCFFFFFFFFFCCPPP",
    "CCCCCCCCCCCCCCCCCCCCCCCCCCCCFFFFFFFFCPPP",
    "CCCCCCCCCCCCCCCCCCCCCCCCCCCCCFFFFFFFFPPP",
    "CCCCCCCCCCCCCCCCCCCCCCCCCCCCCCCFFFFFFPPP",
    "CCCCCCCCCCCCCCCCCCCCCCCCCCCCCCCCFFFFFPPP",
    "CCCCCCCCCCCCCCCCCCCCCCCCCCCCCCCCCCFFFFPP",
    "CCCCCCCCCCCCCCCCCCCCCCCCCCCCCCCCCCCCCPPP",
    "CCCCCCCCCCCCCCCCCCCCCCCCCCCCCCCCCCCCCPPP",
    "CCCCCCCCCCCCCCCCCCCCCCCCCCCCCCCCCCCCCPPP",
    "vCCCCCCCCCCCCCCCCCCCCCCCCCCCCCCCCvCCPPPP",
    "CCCCCCCCCCCCCCCCCCCCCCCCCCCCCCCCCCCCCPPP",
    "CCCCCCCCCCCCCCCCCCCCCCCCCCCCCCCCCCCCCPPP",
    "vCCCCCCCCCCCCCCCCCCCCCCCCCCCCCCCCvCCPPPP",
    "CCCCCCCCCCCCCCCCCCCCCCCCCCCCCCCCCCCCCPPP",
    "CCCCCCCCCCCCCCCCCCCCCCCCCCCCCCCCCCCCCPPP",
    "CCCCCCCCCCCCCCCCCCCCCCCCCCCCCCCCCCCCCPPP",
    "CCCCCCCCCCCCCCCCCCCCCCCCCCCCCCCCCCCCCPPP",
    "CCCCCCCCCCCCCCCCCCCCCCCCCCCCCCCCCCCCCPPP",
    "CCCCCCCCCCCCCCCCCCCCCCCCCCCCCCCCCCCCCPPP",
    "CCCCCCCCCCCCCCCCCCCCCCCCCCCCCCCCCCCCPPPP",
    "CCCCCCCCCCCCCCCCCCCCCCCCCCCCCCCCCCCCCCCC"
  ]
}