{
  "id": "reach_corner_30",
  "name": "抢角·30×30",
  "description": "Reach 模式：冲到 (0,0) 即胜（4 角各 1 城堡）",
  "biome": "grass",
  "size": 30,
  "win_condition": "reach",
  "reach_tile": {
    "x": 0,
    "y": 0
  },
  "chars": {
    "P": "plain",
    "F": "forest",
    "M": "mountain",
    "R": "river",
    "C": "castle",
    "v": "village",
    "b": "barracks",
    "r": "road",
    "g": "gate"
  },
  "layout": [
    "vCCCCCCCCCCCCCCCCCCCCCCCvCCCPP",
    "CCCCCCCCCCCCCCCCCCCCCCCCCCCCCP",
    "CCCCCCCCCCCCCCCCCCCCCCCCCCCCCP",
    "CCCCCCbCCCCCFFFFFFFFFFCCCCCCCP",
    "CCCCCCCCCCCFFFFFFFFFCCCCCCCCPP",
    "CCCCCCCCCCCFFFFFFFFFCCCCCCCCPP",
    "CCCCCCCCCCCFFFFFFFFFCCCCCCCCPP",
    "CCCCCCCCCCCCFFFFFFFFCCCCCCCCCP",
    "CCCCCCCCCCCCFFFFFFFFCCCCCCCCCP",
    "CCCCCCCCCCCCCRRRRRRCCCCCCCCCCP",
    "CCCCCCCCCCCCRRRRRRRCCCCCCCCCCP",
    "CCCCCCCCCCCCCFFCCCCCCCCCCCCCCP",
    "CCCCCCCCCCCCCFFCCCCCCCCCCCCCCP",
    "CCCCCCCCCCCCCCCFFCCCCCCCCCCCCP",
    "CCCCCCCCCCCCCCCCCFFCCCCCCCCCCP",
    "CCCCCCCCCCCCCCCCCCFFCCCCCCCCCP",
    "CCCCCCCCCCCCCCCCCCCFFCCCCCCCCP",
    "CCCCCCCCCCCCCCCCCCCCFFCCCCCCPP",
    "CCCCCCCCCCCCCCCCCCCCCFFCCCCCCP",
    "CCCCCCCCCCCCCCCCCCCCCCFFCCCCCP",
    "CCCCCCCCCCCCCCCCCCCCCCCFFCCCCP",
    "CCCCCCCCCCCCCCCCCCCCCCCCCFFCCP",
    "CCCCCCCCCCCCCCCCCCCCCCCCCCCFFP",
    "CCCCCCCCCCCCCCCCCCCCCCCCCCCCFP",
    "CCCCCCCCCCCCCCCCCCCCCCCCCCCCbP",
    "CCCCCCCCCCCCCCCCCCCCCCCCCCCCCP",
    "CCCCCCCCCCCCCCCCCCCCCCCCCCCCCP",
    "CCCCCCCCCCCCCCCCCCCCCCCCCCCCCP",
    "vCCCCCCCCCCCCCCCCCCCCCCCCvCCCP",
    "CCCCCCCCCCCCCCCCCCCCCCCCCCCCCP"
  ]
}